la, lane, ln => lane
key => key
piaz => piazza
w => west
e => east
cyd, ctyd => courtyard
ss => saints
ftwy => footway
cs, crss => cross
caus, cswy, cway => causeway
hvn => haven
uni, univ => university
path => path
ce, cov, cove, cv => cove
folw => follow
fr, frtg => frontage
cvn => caravan
tn, tarn => tarn
phwy, pway, pwy => pathway
prm, prom => promenade
exp, expy, expwy => expressway
cnc, con => concourse
pnt, pt => point
dle, dale => dale
pkwy, pky, pwy => parkway
dr, drv, dv => drive
hwy => highway
dstr => distributor
blvd, bvd => boulevard
sh, shwy => state highway
edg, edge => edge
ga, gte => gates
ck, cr, crk => creek
strwy => stairway
port, pt => port
nw => northwest
qdrt, qd => quadrant
cve => curve
bch => beach
ctrl => central
sd, stra => strand
wyn, wynd => wynd
park, pk => park
sr => sister
crst, cst => crest
form => formation
artl => arterial
rowy => right of way
rdg, rdge => ridge
pde => parade
sta, stn => station
dn => down
cr => county road
crc, crcs => circus
cft => croft
crt, ct => court
mil => military
r, riv, rvr => river
blk => block
intl => international
sw => southwest
pct => precinct
pl => place
rge, rnge => range
tn, trn, turn => turn
trce => trace
al, all, ally, aly => alley
ambl => amble
ne => northeast
dn => downs
brk => break
rdwy, rdy => roadway
arty => artery
gdn => garden
lit, lt => little
cso => corso
vlls => villas
tr, trk => track
jr => junior
rty => rotary
link, lk => link
aprt => airport
mnr => manor
fl, flat => flat
mt => mount
sbwy => subway
pass, ps => pass
qdgl => quadrangle
line, ln => line
gr => grovet
crsg, csg, xing => crossing
cen, ctr => centre
cds, csac => cul-de-sac
mtn => mountains
ex => extension
tun => tunnel
hird, hrd => highroad
mdw, mdws => meadows
ftrk => fire track
hbr => harbour
jctn, jnc => junction
snd => sound
po => post office
vdct, via, viad => viaduct
n => north
rt, rte => route
elb => elbow
cir => circle
geo => george
res => reserve
apch, app => approach
dip => dip
hd => head
term => terminal
hosp => hospital
ent => entrance
trl => trail
bldgs, bldngs => buildings
sdng => siding
rtn => return
bdwy, bway, bwy => broadway
yard, yd => yard
rvwy => riverway
robt => robert
fd => field
md => mead
ra, rmbl => ramble
up, upr => upper
thfr, thor => thoroughfare
pdse => paradise
hbr => harbor
brk => brook
hd => heads
nra => national recreation area
rue => rue
rest, rst => rest
run => run
drwy, dvwy, dwy => driveway
arc => arcade
whrf => wharf
esp => esplanade
basn, bsn => basin
tce, ter, terr => terrace
mi => mile
nwra => national wildlife refuge area
alwy => alleyway
ldg => landing
ri, rise => rise
hl, hls => hills
mtn => mountain
frnt => front
gln, glen => glen
walk, wk, wlk => walk
cnr, crn => corner
mall, ml => mall
mun => municipal
angb => air national guard base
afb => air force base
mans => mansions
tri => triangle
np => national park
rdsd => roadside
out, otlk => outlook
pl, plz, plza => plaza
va, vale => vale
apts => apartments
cr => county route
cen, ctr => center
ms => middle school
gr, gro => grove
top => top
cps => copse
pkt => pocket
tor => tor
st => saint
ind => industrial
av, ave => avenue
wtr => waters
vy => valley
bywy => byway
sr => senior
bwlk => boardwalk
row => row
swy, svwy => serviceway
accs => access
pl => plain
bend, bnd => bend
gra => grange
ch => church
tpk, tpke => turnpike
plat => plateau
st => street
mews, mw => mews
sr => state route
mdr, mndr, mr => meander
qy => quay
vill => village
frwy, fwy => freeway
slpe => slope
cotts => cottages
cmn, comm => common
psge => passage
fit => firetrail
rch => reach
way, wy => way
qy, qys => quays
quad => quad
cl => close
crd => crossroad
ga, gte => gate
twrs => towers
bps, byp, bypa => bypass
pl => plains
strp => strip
gl, gld, glde => glade
upas, ups => underpass
cty => city
brw, brow => brow
wkwy, wky => walkway
cowy => crossway
hgts, ht, hts => heights
gwy => gateway
lkt => lookout
loop, lp => loop
pkld => parklands
nk, nook => nook
lgn => lagoon
res => reservoir
end => end
rt, rtt => retreat
bl => bowl
mem => memorial
grnd => ground
mdw => meadow
br, brae => brae
spur => spur
fr => father
ba => banan
bk => back
l => lakes
rds => roads
gdn, gdns => gardens
tkwy => trunkway
cnwy => centreway
med => medical
ho, hse => house
se => southeast
rvra => riviera
lnwy => laneway
sq => square
bus => business
low, lr, lwr => lower
mid => middle
trlr => trailer
shun => shunt
est => estate
res => reservation
mtwy, mwy => motorway
rks => rocks
cutt => cutting
fshr => foreshore
gn, grn => green
mkt => market
fy => ferry
wm => william
rgwy => ridgeway
cr, cres => crescent
bdge, br, brdg, bri => bridge
s, sth => south
i, is => island
vw, view => view
ch => chase
vst, vsta => vista
ft => fort
gly => gully
rd => road
comm => community
br => brace
gap => gap
ldg => lodge
cct, ci => circuit
hs => high school
hill, hl => hill
twp => township
rnd => round
devn => deviation
fawy, fy => fairway
rsbl => rosebowl
tlwy, twy => tollway
intg => interchange
rnde => ronde
co => county
bdy => boundary
pk => pike
mus => museum
